wwwwwwwwwwwwwwwwwwwwwwwwwwwwwwwwwwwwwwwwwwwwwwwwwwwwwwwwwwwwwww
w.............................................................w
w.............................................................w
w.............................................................w
w.............................................................w
w.......wwwww......wwwww......................................w
w.......w..............w......................................w
w.......w..............w......................................w
w.......w..............w......................................w
w.......w..............w......................................w
w.............................................................w
w..............ww.............................................w
w..............ww.............................................w
w.............................................................w
w.......w..............w......................................w
w.......w..............w......................................w
w.......w..............w......................................w
w.......w..............w......................................w
w.......wwwww......wwwww......................................w
w.............................................................w
w.............................................................w
w.............................................................w
w.............................................................w
w.............................................................w
w.............................................................w
w.............................................................w
w.............................................................w
w.............................................................w
w..wwwwww..wwwwww..wwwwww..wwwwww..wwwwww..wwwwww..wwwwwwwww..w
w..w....w..w....w..w....w..w....w..w....w..w....w..w.......w..w
w..w....w..w....w..w....w..w....w..w....w..w....w..w.......w..w
w..w....w..w....w..w....w..w....w..w....w..w....w..w.......w..w
w..w....w..w....w..w....w..w....w..w....w..w....w..w.......w..w
w..w....w..w....w..w....w..w....w..w....w..w....w..w.......w..w
w..wwwwww..wwwwww..wwwwww..wwwwww..wwwwww..wwwwww..wwwwwwwww..w
w.............................................................w
w.............................................................w
w.............................................................w
w.............................................................w
w.............................................................w
w.....................................................p.......w
w.............................................................w
w.............................................................w
w.............................................................w
w.............................................................w
w.............................................................w
w.............................................................w
wwwwwwwwwwwwwwwwwwwwwwwwwwwwwwwwwwwwwwwwwwwwwwwwwwwwwwwwwwwwwww
